1111111111
1P11111C01
1111111001
1C000000E1
1111111111