11111111111111111111111111111111111111111111111111
1E1100000000000C0001111001110C00000C00C00000C00011
10100101001000001001010010000010100100010100110101
10100100101010101001001010101000100101000100110101
100000C00C00C0000000000C00C000000000000000000000C1
1C0000000000000C0000000000000C00000C00C00000C00001
10100101001000001001010010000010100100010100110101
10100100101010101001001010101000100101000100110101
1100C0000C00C0000000000C00C0000C0000000000000000C1
1C0000000000000C0000000000000C00000C00C00000C00011
10100101001000001001010010000010100100010100110111
10100100101010101001001010101000100101000100110111
110000C00C00C0000000000C00C000000000000000000000C1
1C0000000000000C0000000000000C00000C00C00000C00001
10100101001000001001010010000010100100010100110101
10100100101010101001001010101000100101000100110101
1C000CC00C00C0000000000C00C0000000000C0000000000C1
110000000000000C0000000000000C00000C00C00000C00001
1C100101001000001001010010000010100100010100110101
10100100101010101001001010101000100101000100110101
1P0000000C00C1111111000C00C000000111000000111000C1
11111111111111111111111111111111111111111111111111
