1111111111
1C000000E1
1110011011
1C0000C001
1011101111
1C0000C001
1C0111P1C1
1111111111
