11111111111111111111111111111111111111111111111111
1P0000000000000000010000000000000000000000000000C1
10111111101111011111011111110111111111111111110111
1C0000000100000001C00000010000000001000000010000C1
10101111010111110111111110111111110111111110111011
1000100001C000000000000000000000000000000001000001
10111011111111011111111111111111111111111111111111
1C0000000000000100000000000000000000000000000000C1
10111111111111111111111101111111111111111111111111
10000000000000000000000000000000000000000000000001
11111111111111111111111111111111111111111111110111
1C0000000000000000000000000000000000000000000000C1
11111111111111111111111111111111111111111111110111
10000000000000000000000000000000000000000000000001
10111111111111111111111111111111111111111111111111
1C0000000000000000000000000000000000000000000000E1
11111111111111111111111111111111111111111111111111
