111111111
1001C1001
111101111
1P00E00C1
100101111
1001C1001
111111111
