111111111111111
1P0000E000000C1
111111111111111