111111111111111
1P00EC000000011
111111111111111
