1111111111
1P00000C01
1000110001
1C000000E0
1111111110