1111111111
1P00000C01
1E001100E1
1C00000001
1111111111