1111111111
1P00000C01
1P00110001
1C000000E1
1111111111