11111111111111111111
1P00C000C00000010001
10000000010101000101
100000000C01C1011001
10101111000101C10011
10100001111101110011
1C10C1000000000E1001
11111111111111111111
