11111111111111111111
1P00C000C00000010001
10000000010101000101
100000000C01C1011C01
10101111000101C10011
1010000111110111C011
1C10C1000000000E10C1
11111111111111111111