1111111
100P111
1C00E00
1111111
