1111111111
1P000000E1
1110X11011
1C0000C001
1011101111
1C0000C001
1C011101C1
1111111111