111111111111111111111
1P00C000C000000010001
100000000101010000101
100000000C01C10011C011
10101111000101C010011
10100001111101111C011
1C10C1000000000E010C1
111111111111111111111